fjhkfskdk_map
0000##0000000000
0000##0000000000
0000##0000000000
0000##0000##%%%%
%%%%##0000##%%%%
%%%%##0000##%%%%
%%%%##0000##0000
0000000000##0000
0000000000##0000
0000000000##0000
0 0
15 9