Level_name_2
0000#00000000000
0000#0000000#000
0000#0000000#000
0000#000#####000
0000#00000000000
0000000003000000
0000000004000000
0000000000000000
0000000000000000
0000000000000000
2 2