test_level_1
0000#00000000000
0000#00000000000
0000#00000002000
0000#00000003000
0000#00000000000
0000%00000000000
0000%00000000000
0000%00000000000
0000%00000000000
0000%00000000000
2 2