lsdhfdslk_map
000000000000#000
00#000000000#000
0000#00%%0000000
0000#0%%%%000000
0000#%%%%%%#0000
000000%%%%0#0000
0000000%%00#0000
00000#000000000#
000#000000#00000
0000000000000000
5 0
10 9