test_level_2players
0000#00000000000
0000#0000000#000
0000#0000000#00#
0000#%%%#####00#
0000#0000000000#
0000%0000000000#
0000%0000000000#
0000%%%%#######0
0000000000000000
0000000000000000
2 2
9 9
